NO srcs/img/NORTH.png
SO srcs/img/2.png
WE srcs/img/WEST.png
EA srcs/img/EAST.png

F 200,200,200
C 200,200,200

1111111111111111111111111
1000110000100000000000001
1000110000000000111111001111111111111111111111111111111111111111111111111111111111111111111111111111111111111111
100011000000000011000100000E000000000000000000000000000000000000000000000000000000000000000000000000000000000001
1000000000100000000001001111111111111111111111111111111111111111111111111111111111111111111111111111111111111111
1111111111111111111111111
