        NO          srcs/img/NORTH.png
SO srcs/img/SOUTH.png
WE srcs/img/WEST.png
EA srcs/img/EAST.png

        F            000, 200,000
C 000,000,255

111111
100N01
100101
100001
111111