NO srcs/img/NORTH.png
SO srcs/img/SOUTH.png
WE srcs/img/WEST.png
EA srcs/img/EAST.png

F 20,20,20
C 200,200,200
11111111111111111111111111111111111111111111111111
10000000000000000000000000000000000000000000000001
10000000011111111000000001111111100000000111111111
10000000000000000000000000000000000000000000000001
10000000000000000000000000000000000000000000000001
10000000000000000000000000000000000000000000000001
10011110001111000011110000111100001111000011110001
10000000000000000000000000000000000000000E000000001
100000000111111110000000011111111100100000111111111
101010101010101010101010101010101001010101010101011
10000000000000000000000000000000000000000000000001
10000000011111111000000001111111100000000111111111
10011110001111000011110000111100001111000011110001
10000000000000000000000000000000000000000000000001
101010101010101010101010101010101010101010101010101
10000000000000000000000000000000000000000000000001
10000000011111111000000001111111100000000111111111
10000000000000000000000000000000000000000000000001
11111111111111111111111111111111111111111111111111
