NO img/128/duke/north.xpm
SO img/128/duke/south.xpm
WE img/128/duke/west.xpm
EA img/128/duke/east.xpm

F ./img/128/duke/floor.xpm
C ./img/128/duke/ceiling.xpm

111111111111111111111
1000000000000Q00000E1
111111111111111111111