NO                srcs/img/NORTH.png

SO srcs/img/SOUTH.png
WE srcs/img/WES   T.png
   EA                srcs/img/EAST.png

F 000,200,000
C 000,000,255

111111111111
10E011111111
1111111111111