NO img/128/duke/north.xpm
SO img/128/duke/south.xpm
WE img/128/duke/west.xpm
EA img/128/duke/east.xpm

F 20,20,20
C 200,200,200
        1111111111111111111111111
        1F1000000110000000000001
        1111000001110000000000001
        1001000000000000000000001
111111111011000001110000000000001
100000000011000001110111111111111
11110111111111011100000010001
11110111111111011101010010001
11000000110101011100000010001
10000000000000001100000010001
10000000000000001101010000001
1100000111010101111101111000111
11110111 1110101 101111010001
11111111 1111111 11111111111
