NO                srcs/img/NORTH.png

SO srcs/img/SOUTH.png
WE srcs/img/WEST.png
   EA                srcs/img/EAST.png

C 000,000,255
F 000,200,000



1111111111111111111111111111111
1000000000100000000000000000001
 10000N000100000000000000000001
  10000000100001111100000000001
  10000000000000000000100100001
  11111111111111111111111111111