NO srcs/img/NORTH.png
EA srcs/img/EAST.png
SO srcs/img/2.png
WE srcs/img/WEST.png

C 0,255,17
F 229,61,61

1111111111111111111111111111111111111111111111111111111111111111111111111111111111111111111111111111111
1000000000100000100000000001000000000100000001000000000000100000001000000000010000000001000000000000001
1011111110101110101111111101011111110101111101011111111110101111101011111111110111111101011111111111101
1010000010100010100000000101010000010100000101010000000010100000101010000000010000000101010000000000101
10101110101110101111111101010101110101111101010101111110101111101010101111110111111101010101111111101011111111111111
        1     1010001010001010000000010101010001010000010101010100001010000010101010100000000000010101010100000010101
10101010111010111111110101010101010111110101010101011010111110101010101011111111110101010101011111101011111111111111
1010101000001010000001010101010101000001010101010101001010000010101010101000000001010101010101000010101
1010101111111010111101010101010101111101010101010101111010111010101010101011111101010101010101011110101
1010100000000010100001010101010100000101010101010100000010001010101010101010000001010101010101010000101
1010111111111110101101010101010111110101010101010111111111101010101010101010111101010101010101010111101
1010000000000000101001010101010000010101010101000000000000101010101010101010100001010101010101010100001
1011111111111111101111010101011111010101010101111111111110101010101010101010101111010101010101010101111
1000000000000000100000010101000001010101010100000000000010101010101010101010100000010101010101010100001
1111111111111110111111110101111101010101010111111111111010101010101010101010111111110101010101010111101
1000000000000010000000000100000101010101010000000000001010101010101010101000000000010101010101000000101
1011111111111011111111111111110101010101011111111111101010101010101010101111111111110101010101111110101
1010000000001000000000000000010101010101000000000000101010101010101010100000000000000101010100000010101
1010111111101111111111111111010101010101111111111110101010101010101010111111111111111101010111111010101
1010100000100000000000000001010101010100000000000010101010101010101000000000000000000001010000001010101
1010101110111111111111111101010101010111111111111010101010101010101111111111111111111101011111101010101
1010101010000000000000000101010101010000000000001010101010101010100000000000000000000101010000101010101
1010101011111111111111110101010101011111111111101010101010101010111111111111111111110101010110101010101
1010101000000000000000010101010101000000000000101010101010101010000000000000000000010101010010101010101
1010101111111111111111010101010101111111111110101010101010101011111111111111111111010101011110101010101
1010100000000000000001010101010100000000000010101010101010101000000000000000000001010101000010101010101
1010111111111111111101010101010111111111111010101010101010101111111111111111111101010101111010101010101
1010000000000000000101010101010000000000001010101010101010100000000000000000000101010100001010101010101
1011111111111111110101010101011111111111101010101010101010111111111111111111110101010111101010101010101
1000000000000000010101010101000000000000101010101010101010000000000000000000010101010000101010101010101
1111111111111111010101010101111111111110101010101010101011111111111111111111010101011110101010101010101
1000000000000001010101010100000000000010101010101010101000000000000000000001010101000010101010101010101
1011111111111101010101010111111111111010101010101010101111111111111111111101010101111010101010101010101
1010000000000101010101010000000000001010101010101010100000000000000000000101010100001010101010101010101
1010111111110101010101011111111111101010101010101010111111111111111111110101010111101010101010101010101
1010000000010101010101000000000000101010101010101010000000000000000000010101010000101010101010101010101
1011111111010101010101111111111110101010101010101011111111111111111111010101011110101010101010101010101
1000000001010101010100000000000010101010101010101000000000000000000001010101000010101010101010101010101
1111111101010101010111111111111010101010101010101111111111111111111101010101111010101010101010101010101
1000000101010101010000000000001010101010101010100000000000000000000101010100001010101010101010101010101
1011110101010101011111111111101010101010101010111111111111111111110101010111101010101010101010101010101
1010010101010101000000000000101010101010101010000000000000000000010101010000101010101010101010101010101
1010110101010101111111111110101010101010101011111111111111111111010101011110101010101010101010101010101
1010100101010100000000000010101010101010101000000000000000000001010101000010101010101010101010101010101
1010101101010111111111111010101010101010101111111111111111111101010101111010101010101010101010101010101
1010100101010000000000001010101010101010100000000000000000000101010100001010101010101010101010101010101
1010110101011111111111101010101010101010111111111111111111110101010111101010101010101010101010101010101
1010010101000000000000101010101010101010000000000000000000010101010000101010101010101010101010101010101
1011010101111111111110101010101010101011111111111111111111010101011110101010101010101010101010101010101
1001010100000000000010101010101010101000000000000000000001010101000010101010101010101010101010101010101
1101010111111111111010101010101010101111111111111111111101010101111010101010101010101010101010101010101
1001010000000000001010101010101010100000000000000000000101010100001010101010101010101010101010101010101
1011011111111111101010101010101010111111111111111111110101010111101010101010101010101010101010101010101
1010000000000000101010101010101010000000000000000000010101010000101010101010101010101010101010101010101
1010111111111110101010101010101011111111111111111111010101011110101010101010101010101010101010101010101
1010000000000010101010101010101000000000000000000001010101000010101010101010101010101010101010101010101
1011111111111010101010101010101111111111111111111101010101111010101010101010101010101010101010101010101
1000000000001010101010101010100000000000000000000101010100001010101010101010101010101010101010101010101
1111111111101010101010101010111111111111111111110101010111101010101010101010101010101010101010101010101
1000000000101010101010101010000000000000000000010101010000101010101010101010101010101010101010101010101
1011111110101010101010101011111111111111111111010101011110101010101010101010101010101010101010101010101
1010000010101010101010101000000000000000000001010101000010101010101010101010101010101010101010101010101
1010111010101010101010101111111111111111111101010101111010101010101010101010101010101010101010101010101
1010001010101010101010100000000000000000000101010100001010101010101010101010101010101010101010101010101
1010101010101010101010111111111111111111110101010111101010101010101010101010101010101010101010101010101
1010101010101010101010000000000000000000010101010000101010101010101010101010101010101010101010101010101
1010101010101010101011111111111111111111010101011110101010101010101010101010101010101010101010101010101
1010101010101010101000000000000000000001010101000010101010101010101010101010101010101010101010101010101
1010101010101010101111111111111111111101010101111010101010101010101010101010101010101010101010101010101
1010101010101010100000000000000000000101010100001010101010101010101010101010101010101010101010101010101
1010101010101010111111111111111111110101010111101010101010101010101010101010101010101010101010101010101
1010101010101010000000000000000000010101010E00000000000000000000000000000000000000000000000000000000001
1010101010101011111111111111111111010101011110101010101010101010101010101010101010101010101010101010101
1010101010101000000000000000000001010101000010101010101010101010101010101010101010101010101010101010101
1010101010101111111111111111111101010101111010101010101010101010101010101010101010101010101010101010101
1010101010100000000000000000000101010100001010101010101010101010101010101010101010101010101010101010101
1010101010111111111111111111110101010111101010101010101010101010101010101010101010101010101010101010101
1010101010000000000000000000010101010000101010101010101010101010101010101010101010101010101010101010101
1010101011111111111111111111010101011110101010101010101010101010101010101010101010101010101010101010101
1010101000000000000000000001010101000010101010101010101010101010101010101010101010101010101010101010101
1010101111111111111111111101010101111010101010101010101010101010101010101010101010101010101010101010101
1010100000000000000000000101010100001010101010101010101010101010101010101010101010101010101010101010101
1010111111111111111111110101010111101010101010101010101010101010101010101010101010101010101010101010101
1010000000000000000000010101010000101010101010101010101010101010101010101010101010101010101010101010101
1011111111111111111111010101011110101010101010101010101010101010101010101010101010101010101010101010101
1000000000000000000001010101000010101010101010101010101010101010101010101010101010101010101010101010101
1111111111111111111101010101111010101010101010101010101010101010101010101010101010101010101010101010101
1000000000000000000101010100001010101010101010101010101010101010101010101010101010101010101010101010101
1011111111111111110101010111101010101010101010101010101010101010101010101010101010101010101010101010101
1010000000000000010101010000101010101010101010101010101010101010101010101010101010101010101010101010101
1010111111111111010101011110101010101010101010101010101010101010101010101010101010101010101010101010101
1010000000000001010101000010101010101010101010101010101010101010101010101010101010101010101010101010101
1010111111111101010101111010101010101010101010101010101010101010101010101010101010101010101010101010101
1010000000000101010100001010101010101010101010101010101010101010101010101010101010101010101010101010101
1011111111110101010111101010101010101010101010101010101010101010101010101010101010101010101010101010101
1000000000010101010000101010101010101010101010101010101010101010101010101010101010101010101010101010101
1111111111010101011110101010101010101010101010101010101010101010101010101010101010101010101010101010101
1000000001010101000010101010101010101010101010101010101010101010101010101010101010101010101010101010101
1111111111111111111111111111111111111111111111111111111111111111111111111111111111111111111111111111111
